_____H_____E
SSS_S_SSSS__
B___SBS__S_I
____SBS__S__
_B__SSS_KS__
____P____S__
_TBT_____S__
_TTT__+-_B__
__L______B__
BSSSSBBSSSB_
__n____M____
___<___>_S__